1 1 1 1 1 1 1 1 1 1 1 1 1 1 1 1 1 1 1 1 1 1 1 1 1 1 1 1 1 1 1 1 1 1 1 1 1 1 1 1 1 1 1 1 1 1 1 1 1 1
1 0 0 0 0 0 0 0 0 0 0 0 0 0 0 0 0 0 0 R 0 0 0 0 0 0 0 0 0 0 0 0 0 0 0 0 0 0 0 0 0 0 0 0 0 0 0 0 0 1
1 0 0 0 0 0 0 0 0 0 0 0 0 0 0 0 0 0 0 R 0 0 0 0 0 0 0 0 0 0 0 0 0 0 0 0 0 0 0 0 0 0 0 0 0 0 0 0 0 1
1 0 0 0 0 0 0 0 0 0 0 0 D 0 0 0 0 0 0 R 0 0 0 0 0 0 0 0 0 0 0 0 0 0 0 0 0 0 0 0 0 0 0 0 B 0 0 0 0 1
1 0 0 0 0 0 0 0 0 0 0 1 1 1 1 1 1 1 1 R 0 0 0 0 0 0 0 0 0 0 0 0 0 0 0 0 0 0 0 0 0 0 R 0 B 0 0 P 0 1
1 0 0 0 0 0 0 0 0 B 0 0 0 0 0 0 0 0 0 R 0 0 O 0 0 0 0 0 0 0 0 0 0 0 0 0 D 0 0 0 0 0 R 0 B 0 0 0 0 1
1 0 0 0 0 0 0 0 0 B 0 0 0 0 0 0 0 0 0 R 0 0 O 0 0 0 0 0 0 0 0 0 0 0 0 0 1 1 1 0 0 0 R 1 1 1 1 1 1 1
1 0 0 0 0 0 1 1 0 B 0 0 0 0 0 0 0 0 0 R 0 0 O 0 0 0 0 0 0 0 0 0 0 0 0 0 0 0 0 0 0 0 R 0 0 0 0 0 0 1
1 0 0 O 0 0 R 0 0 B 0 0 0 0 0 0 0 0 0 R 0 0 O 0 0 0 0 0 0 0 0 0 0 0 0 0 0 0 0 0 0 0 R 0 0 0 0 0 0 1
1 0 0 O 0 0 R 0 0 0 0 0 0 0 0 0 D 0 0 R 0 0 O 0 0 0 0 0 0 0 0 0 0 0 0 0 0 0 0 0 0 0 R 0 0 0 0 0 0 1
1 0 0 O D 0 R 0 0 1 1 1 1 1 1 1 1 1 1 R 1 0 O 0 0 0 0 0 0 0 0 0 0 0 0 0 0 0 0 0 0 0 R 0 0 0 0 0 0 1
1 1 1 1 1 1 R 0 0 0 0 0 0 R 0 0 0 0 0 R 0 0 0 0 0 0 0 0 0 0 0 0 0 0 0 0 0 0 0 0 0 0 R 0 0 0 0 0 0 1
1 0 R 0 0 0 R 0 0 0 0 0 0 R 0 0 0 0 0 R 0 0 0 0 0 0 0 0 0 0 0 0 0 0 0 0 0 0 0 0 0 0 R 0 0 0 0 0 0 1
1 0 R 0 0 0 R 0 0 0 0 0 0 R 0 0 0 D 0 R 0 0 0 0 0 0 0 0 0 0 0 0 0 0 0 0 0 0 0 0 O O R 0 0 0 0 0 0 1
1 0 R 0 S 0 R 0 0 0 0 0 0 R 1 1 1 1 1 R 0 0 0 0 0 0 0 0 0 0 0 0 0 0 0 0 0 0 0 0 O O R 0 0 0 0 0 0 1
1 0 R 1 1 1 1 0 0 0 0 0 0 R 0 0 0 0 0 R 0 0 0 0 0 0 0 0 0 0 0 0 0 0 0 0 0 0 0 0 O O R 0 0 0 0 0 0 1
1 0 R 0 0 0 0 0 0 0 0 0 0 R 0 0 0 0 0 R 0 0 0 0 0 0 0 0 0 0 0 0 0 0 0 0 0 0 0 0 0 0 R 0 0 R 0 0 0 1
1 0 R 0 0 0 0 0 0 0 0 0 0 R 0 0 0 0 0 R 0 0 S 0 0 D 0 0 0 R 0 0 0 0 0 0 0 0 0 0 1 1 1 1 1 R 0 0 0 1
1 0 R 0 0 0 0 0 0 0 0 0 0 R 1 1 1 1 1 1 1 1 1 1 1 1 1 1 1 R 0 0 0 0 0 0 0 0 0 0 0 0 0 0 0 R 0 0 0 1
1 0 R 0 0 0 0 0 0 0 0 0 0 R 0 0 0 0 0 0 0 0 0 0 0 0 0 0 0 R 0 0 0 0 0 0 0 0 0 0 0 0 0 0 0 R 0 0 0 1
1 0 R 0 0 0 0 0 0 0 0 0 0 R 0 0 0 0 0 0 0 0 0 0 0 0 0 0 0 R 0 0 0 0 0 0 0 0 0 0 0 0 0 0 0 R 0 0 0 1
1 0 R 0 0 0 0 0 0 0 0 0 0 R 0 0 0 0 0 0 0 0 0 0 0 0 0 0 0 R 0 0 0 0 0 0 0 0 0 0 0 0 0 0 0 R 0 0 0 1
1 0 R 0 0 0 0 0 0 0 0 0 0 R 0 0 0 0 0 0 0 0 0 0 0 0 0 0 0 R 0 0 0 0 0 0 0 0 0 0 0 0 0 0 0 R 0 0 0 1
1 0 R 0 0 0 0 0 0 0 0 0 0 R 0 0 0 B 0 0 0 0 0 0 0 0 R 0 0 R 0 0 0 0 0 S 0 0 0 0 D 0 0 0 0 R 0 0 0 1
1 0 R 0 0 0 0 0 0 0 0 0 0 R 0 0 0 B 0 0 0 0 0 0 0 0 R 1 1 1 1 1 1 1 1 1 1 1 1 1 1 1 1 1 1 1 1 1 1 1
1 0 R 0 0 0 0 0 0 0 0 0 0 R 0 0 0 B 0 0 S 0 V 0 D 0 R 0 0 0 0 0 0 0 0 0 0 0 0 0 0 0 0 0 0 0 0 0 0 1
1 0 R 0 0 0 0 0 0 0 0 0 0 R 1 1 1 1 1 1 1 1 1 1 1 1 R 0 0 0 0 0 0 0 0 0 0 0 0 0 0 0 0 0 0 0 0 0 0 1
1 0 R 0 0 0 0 0 0 0 0 0 0 R 0 0 0 0 0 0 0 0 0 0 0 0 R 0 0 0 0 0 0 0 0 0 0 0 0 0 0 0 0 0 0 0 0 0 0 1
1 0 R 0 0 0 0 0 0 0 0 0 0 R 0 0 0 0 0 0 0 0 0 0 0 0 R 0 0 0 0 0 0 0 0 0 0 0 0 0 0 0 0 0 0 0 0 0 0 1
1 0 R 0 0 0 0 0 0 S 0 0 0 R 0 0 0 0 0 0 0 0 0 0 0 0 R 0 0 0 0 0 0 0 0 0 0 0 0 0 0 0 0 0 0 0 0 0 0 1
1 0 R 0 0 0 1 1 1 1 1 1 1 1 0 0 0 0 0 0 0 0 0 0 0 0 R 0 0 0 0 0 0 0 0 0 0 0 0 0 0 0 S 0 0 0 0 0 0 1
1 0 R 0 0 0 0 0 0 0 0 0 0 0 0 0 0 0 0 0 0 0 0 0 0 0 R 0 0 0 0 0 0 0 0 O 1 1 1 1 1 1 1 0 0 0 0 0 0 1
1 0 R 0 0 0 0 0 0 0 0 0 0 0 0 0 0 0 0 0 0 0 0 0 0 0 R 0 0 0 0 0 0 0 0 O 0 0 0 0 0 0 0 0 0 0 0 0 0 1
1 0 R 0 0 0 0 0 0 0 0 0 0 0 0 0 0 0 0 0 S 0 0 0 0 0 R 0 0 0 0 0 0 0 0 O 0 0 0 0 0 0 D 0 0 0 0 0 0 1
1 1 1 1 1 1 1 1 1 1 1 1 1 1 1 1 1 1 1 1 1 1 1 1 1 1 1 1 1 1 1 1 1 1 1 1 1 1 1 1 1 1 1 1 1 1 1 1 1 1